111111111111111111111
1P0000000C00000000001
100000110001111110001
10000111000110C110001
100011010000000110001
10011001C00111111C001
100111111001100000001
10000C1100011C0110001
100111111001111110001
100000000C000000000E1
111111111111111111111