111111111111111111
1C0100000000C01111
1000001111000010C1
11100110C10100C0P1
1C0000000100C11101
1000111111C1000101
100011E00000010101
111111111111111111