11111111111111111111
100000000000000000C1
10000111000011000001
11101101C0110C110001
1C001111000001100001
1000001100C011011001
1P0011111E00111100C1
11111111111111111111