11111111111111111111
1C0100000000C00000C1
10000111110001000001
11100110C10101111001
1C0000000100C1C11001
1000111111C001011001
1P0011E00000110000C1
11111111111111111111