11111111111111
10000C00000001
11100110010101
100C1111110101
1P0011E0000001
11111111111111