
11111
10001
10P01
1E001
10C01
11111